1.............
000...........
000...........
..............
.....00.......
....0000......
...A..........