1...........
000.........
000.........
............
....000.....
...A........