.s..........
......s....1
....s......1
...A....s..1
...........1
...s........