wwwwwwwwwwwwwwwwwwwwwwww
w4___l_____l_____l____2w
w___0_____0_____0____0_w
w______________________w
w______________________w
wnA___________________ew
w______________________w
w______________________w
w____0__0______0___0___w
w4__,_____,___,___,___2w
wwwwwwwwwwwwwwwwwwwwwwww