wwwwwwwwwwwwwwwwwwwwwwwwwwwwwww
wwww3w3wwwwwwwwwwwwwwwwwwwwwwww
...............................
..............................1
.A............................1
..............................1
...............................
...............................
...............................
...............................
..............000000.....000...
.............00000000...00000..
.......000000000000000..000000.
......0000000000000000000000000
wwwwwwwwwwwwwwwwwwwwwwwwwwwwwww
wwwwwwwwwwwwwwwwwwwwwwwwwwwwwww